----------------------------------------
----------------------------------------
----------------------------------------
-----------------------------#----------
---------------------#------------------
----------------------------#-----------
-----------------------#----&-----------
------------------------------#---------
------------------------#---------------
-----------------------------#----------
----------------------#-----------------
---x--------------------------------$---
========================================
========================================
========================================
========================================
========================================
========================================
========================================
========================================
========================================
========================================
========================================
========================================