----------------------------------------
----------------------------------------
----------------------------------------
----------------------------------------
----------------------------------------
----------------------------------------
----------------------------------------
----------------------------------------
----------------------------------------
----------------------------$-----------
----------------------------------------
-------x------^^^^^^^^^^^^--------------
==============^^^^^^^^^^^^==============
========================================
========================================
==============############==============
========================================
========================================
========================================
========================================
========================================
========================================
========================================
========================================