----------------------------------------
----------------------------------------
----------------------------------------
----------------------------------------
----------------------------------------
----------------------------------------
----------------------------------------
----------------------------------------
----------------------------------------
-----------------#2--#------------------
---------------------3------------------
-----x-------------$--------------------
===================$====================
=================3======================
=================#==2#==================
========================================
========================================
========================================
========================================
========================================
========================================
========================================
========================================
========================================