----------------------#-----------------
----------------------------------------
----------------------------------------
----------------------------------------
-----------x----------------------------
-----------####-------------------------
---------------###----3-----------------
------------------#####----#------------
---------------------------~7-----------
----------------------------------------
----------------------------------------
----------------------------------------
========================================
========================================
==============================$=========
========================================
======================######============
========================================
========================================
========================================
========================================
========================================
========================================
========================================