----------------------------------------
----------------------------------------
----------------------------------------
----------------------------------------
----------------------------------------
----------------------------------------
----------------------------------------
----------------------------------------
----------------------------------------
----------------------------------------
---##################################---
---#x--------0------------0--------$#---
===#===============================9#===
===##################################===
========================================
========================================
========================================
========================================
========================================
========================================
========================================
========================================
========================================
========================================