----------------------------------------
----------------------------------------
----------------------------------------
-------------------------#--------------
----------------------------------------
-----------------------------$----------
-------------------0--------------------
----------------------------------------
----------------------------------------
-------------#--------------------------
----------------------------------------
----x-----------------------------------
========================================
========================================
=============0==========================
========================================
========================================
===================#====================
========================================
========================================
=========================0==============
========================================
========================================
========================================