----------------------------------------
----------------------------------------
----------------------------------------
----------------------------------------
----------------------------------------
----------------------------------------
----------------------------------------
----------------------------------------
----------------------------------------
----------------------------------------
----------------------------------------
--------x----------00----------$--------
===================00===================
========================================
========================================
========================================
========================================
========================================
========================================
========================================
========================================
========================================
========================================
========================================