----------------------------------------
----------------------------------------
----------------------------------------
----------------------------------------
----------------------------------------
----------------------------------------
----------------------------------------
----------------------------------------
----------------------------------------
----------------------------------------
---##################################---
---#x--------------00--------------$#---
===#=========#===========6#=========#===
===##################################===
========================================
========================================
========================================
========================================
========================================
========================================
========================================
========================================
========================================
========================================