----------------------------------------
----------------------------------------
----------------------------------------
-------x--------------------------------
-------#####-----#####-----#####--------
----------------------------------------
-----#----------------------------$-----
----------------------------------------
----------------------------------------
---#------------------------------------
----------------------------------------
------------^^^^^-----^^^^^-------------
=================^^^^^==================
========================================
========================================
========================================
========================================
========================================
========================================
============#####=====#####=============
========================================
========================================
========================================
========================================