----------------------------------------
----------------------------------------
----------------------------------------
----------------------------------------
-----##############################-----
-----#---0----0---0--0---0----0---#-----
-----#x--0----0---0--0---0----0--$#-----
-----##############################-----
----------------------------------------
----------------------------------------
----------------------------------------
----------------------------------------
========================================
========================================
========================================
========================================
=====##############################=====
=====#6==========================9#=====
=====#6==========================9#=====
=====##############################=====
========================================
========================================
========================================
========================================