----------------------------------------
----------------------------------------
----------------------------------------
----------------------------------------
----------------------------------------
--------------------------$-------------
----------------------------------------
----------------------------------------
----------------------------------------
--------------#-------------------------
----------------------------------------
--------x-------------------------------
========================================
========================================
========================================
========================================
====================#===================
========================================
========================================
========================================
========================================
========================================
========================================
========================================