----------------------------------------
----------------------------------------
----------------------------------------
----------------------------------------
----------------------------------------
----------------------------------------
--------$-------------------------------
--------############--------------------
-------------------#--------------------
-------------------###########----------
----------------------------------------
--------x-------------------------------
========================================
========================================
========================================
========================================
========================================
========================================
========================================
========================================
========================================
========================================
========================================
========================================