----------------------------------------
----------------------------------------
----------------------------------------
----------------------------------------
----------------------------------------
----------------------------------------
----------------------------------------
-----------------#--$-#-----------------
-----------------#----#-----------------
-----------------######-----------------
----------------------------------------
--------x-------------------------------
========================================
========================================
========================================
========================================
========================================
========================================
========================================
========================================
========================================
========================================
========================================
========================================