----------------------------------------
----------------------------------------
----------------------------------------
----------------------------------------
----------------------------------------
----------------------------------------
----------------------------------------
----------------------------------------
----------------------------------------
----------------------------------------
------~~~~~~~~~~~~~---------------------
---x--------------------------------$---
========================================
====================="""""""""""""======
========================================
========================================
========================================
========================================
========================================
========================================
========================================
========================================
========================================
========================================