----------------------------------------
----------------------------------------
----------------------------------------
----------------------------------------
----------------------------------------
----------------------------------------
----------------------------------------
----------------------------------------
----------------------------------------
----------------------------------------
----------------------------------------
--------x----------------------$--------
========================================
========================================
========================================
========================================
========================================
========================================
========================================
========================================
========================================
========================================
========================================
========================================