----------------------------------------
----------------------------------------
----------------------------------------
----------------------------------------
----------------------------------------
-------------------$--------------------
----------------------------------------
----------------------------------------
----------------------------------------
------------------------###-------------
----------------------------------------
--------------x-------------------------
========================================
========================================
========================================
========================================
========================================
========================================
========================================
========================================
========================================
========================================
========================================
========================================