----------------------------------------
----------------------------------------
----------------------------------------
----------------------------------------
----------------------------------------
----------------------------------------
----------------------------------------
----------------------------------------
----------------------------------------
----------------------------------------
--------~~~~~~~~~~~~~~~~~~~~~~~~--------
-----x----------------------------$-----
========================================
========================================
========================================
========================================
========================================
========================================
========================================
========================================
========================================
========================================
========================================
========================================