----------------------------------------
----------------------------------------
----------------------------------------
----------------------------------------
----###########----------###########----
----#---------############---------#----
----#------------------------------#----
----#x----------------------------$#----
----###########----------###########----
--------------############--------------
----------------------------------------
----------------------------------------
========================================
========================================
==============############==============
====###########==========###########====
====#==============================#====
====#==============================#====
====#=========############=========#====
====###########==========###########====
========================================
========================================
========================================
========================================