----------------------------------------
----------------------------------------
----------------------------------------
----------------------------------------
----------------------------------------
----------------------------------------
----------------------------------------
----------------------------------------
----------------------------------------
----------------------------------------
---##################################---
---#x--0---0---0--0--0--0---0---0--$#---
===#5==============================5#===
===##################################===
========================================
========================================
========================================
========================================
========================================
========================================
========================================
========================================
========================================
========================================