----------------------------------------
----------------------------------------
----------------------------------------
----------------------------------------
----------------------------------------
----------------------------------------
----------------------------------------
----------------------------------------
----------------------------------------
----------------------------------------
----------------------------------------
--------x-------------------------------
========================================
========================================
==================####==================
========================================
========================================
==========================$=============
========================================
========================================
========================================
========================================
========================================
========================================