----------------------------------------
----------------------------------------
----------------------------------------
----------------------------------------
-----##############################-----
-----#---------------------------9#-----
-----#x--------------------------9#-----
-----##############################-----
----------------------------------------
----------------------------------------
----------------------------------------
----------------------------------------
========================================
========================================
========================================
========================================
=====##############################=====
=====#=====================9=====$#=====
=====#=====================9======#=====
=====##############################=====
========================================
========================================
========================================
========================================