----------------------------------------
----------------------------------------
----------------------------------------
----------------------------------------
----------------------------------------
-------------------$--------------------
----------------------------------------
----------------------------------------
----------------------------------------
----------------------------------------
----------------------------------------
-------------------x--------------------
========================================
========================================
=================#####==================
========================================
========================================
========================================
========================================
========================================
========================================
========================================
========================================
========================================