----------------------------------------
----------------------------------------
----------------------------------------
-------x--------------------------------
------###-------------------------------
----------------------------------------
--------:-------------------------------
:-------:---------------:---------------
:-------:---------------:-------:-------
:-------:-------:-------:-------:-------
:-------:-------:-------:-------:-------
:-------:-------:-------:-------:---$---
====:=======:=======:=======:=======:===
====:=======:=======:=======:=======:===
====:=======:=======:=======:=======:===
============:=======:=======:=======:===
============:===============:===========
============================:===========
============================:===========
========================================
========================================
========================================
========================================
========================================