----------------------------------------
-------------------$-------------------
----------------------------------------
----------------------------------------
----------------------------------------
----------------------------------------
----------------------------------------
--------------#--------5#---------------
----------------------------------------
----------------------------------------
-------------------##-------------------
--------x-------------------------------
========================================
========================================
========================================
========================================
========================================
========================================
=================######=================
=================#======================
=================#======================
=================#======================
=================#======================
=================#======================