----------------------------------------
----------------------------------------
----------------------------------------
----------------------------------------
----------------------------------------
----------------------------------------
----------------------------------------
-----------------------#----------------
---------------#*------&----------------
---------------------#------------------
-----------------#*--&------------------
-----x----------------------------$-----
=======================================
==================*==&#=================
==================#=====================
================*======&#===============
================#=======================
========================================
========================================
========================================
========================================
========================================
========================================
========================================